Date,Amount,Reference,Description,Particulars,Balance
15/07/19,-954.97,"","Loan Interest To 14/07/2","019         ",-287841.95
15/07/19,1512.94,"","Payment Ex: 70015100647 ","Repayment   ",-286329.01
15/08/19,-984.89,"","Loan Interest To 14/08/2","019         ",-287313.90
15/08/19,1512.94,"","Payment Ex: 70015100647 ","Repayment   ",-285800.96
15/09/19,-983.07,"","Loan Interest To 14/09/2","019         ",-286784.03
15/09/19,1512.94,"","Payment Ex: 70015100647 ","Repayment   ",-285271.09
