Date,Amount,Reference,Description,Particulars,Balance
15/05/20,-988.65,"","Loan Interest To 14/05/2","020         ",-292944.65
15/05/20,1525.73,"","Payment Ex: 70015100647 ","Repayment   ",-291418.92
15/06/20,-1019.72,"","Loan Interest To 14/06/2","020         ",-292438.64
15/06/20,1525.73,"","Payment Ex: 70015100647 ","Repayment   ",-290912.91
15/07/20,-985.11,"","Loan Interest To 14/07/2","020         ",-291898.02
15/07/20,1525.73,"","Payment Ex: 70015100647 ","Repayment   ",-290372.29
