Date,Amount,Reference,Description,Particulars,Balance
15/12/19,-862.63,"","Loan Interest To 14/12/2","019         ",-265046.51
15/12/19,1203.00,"","Payment Ex: 70015100647 ","Repayment   ",-263843.51
15/01/20,-773.09,"","Loan Interest To 14/01/2","020         ",-264616.60
15/01/20,1203.00,"","Payment Ex: 70015100647 ","Repayment   ",-263413.60
15/02/20,-771.83,"","Loan Interest To 14/02/2","020         ",-264185.43
15/02/20,1203.00,"","Payment Ex: 70015100647 ","Repayment   ",-262982.43
