Date,Amount,Reference,Description,Particulars,Balance
15/03/20,-959.19,"","Loan Interest To 14/03/2","020         ",-293984.10
15/03/20,1525.73,"","Payment Ex: 70015100647 ","Repayment   ",-292458.37
15/04/20,-1023.36,"","Loan Interest To 14/04/2","020         ",-293481.73
15/04/20,1525.73,"","Payment Ex: 70015100647 ","Repayment   ",-291956.00
15/05/20,-988.65,"","Loan Interest To 14/05/2","020         ",-292944.65
15/05/20,1525.73,"","Payment Ex: 70015100647 ","Repayment   ",-291418.92
