Date,Amount,Reference,Description,Particulars,Balance
15/07/19,-1005.94,"","Loan Interest To 14/07/2","019         ",-298070.55
15/07/19,1525.73,"","Payment Ex: 70015100647 ","Repayment   ",-296544.82
15/08/19,-1037.66,"","Loan Interest To 14/08/2","019         ",-297582.48
15/08/19,1525.73,"","Payment Ex: 70015100647 ","Repayment   ",-296056.75
15/09/19,-1035.95,"","Loan Interest To 14/09/2","019         ",-297092.70
15/09/19,1525.73,"","Payment Ex: 70015100647 ","Repayment   ",-295566.97
