Date,Amount,Reference,Description,Particulars,Balance
15/12/19,-997.42,"","Loan Interest To 14/12/2","019         ",-295546.20
15/12/19,1525.73,"","Payment Ex: 70015100647 ","Repayment   ",-294020.47
15/01/20,-1028.82,"","Loan Interest To 14/01/2","020         ",-295049.29
15/01/20,1525.73,"","Payment Ex: 70015100647 ","Repayment   ",-293523.56
15/02/20,-1027.08,"","Loan Interest To 14/02/2","020         ",-294550.64
15/02/20,1525.73,"","Payment Ex: 70015100647 ","Repayment   ",-293024.91
