Date,Amount,Reference,Description,Particulars,Balance
15/05/20,-743.11,"","Loan Interest To 14/05/2","020         ",-262809.54
15/05/20,1203.00,"","Payment Ex: 70015100647 ","Repayment   ",-261606.54
15/06/20,-766.54,"","Loan Interest To 14/06/2","020         ",-262373.08
15/06/20,1203.00,"","Payment Ex: 70015100647 ","Repayment   ",-261170.08
15/07/20,-740.57,"","Loan Interest To 14/07/2","020         ",-261910.65
15/07/20,1203.00,"","Payment Ex: 70015100647 ","Repayment   ",-260707.65
