Date,Amount,Reference,Description,Particulars,Balance
15/03/20,-720.85,"","Loan Interest To 14/03/2","020         ",-263703.28
15/03/20,1203.00,"","Payment Ex: 70015100647 ","Repayment   ",-262500.28
15/04/20,-769.15,"","Loan Interest To 14/04/2","020         ",-263269.43
15/04/20,1203.00,"","Payment Ex: 70015100647 ","Repayment   ",-262066.43
15/05/20,-743.11,"","Loan Interest To 14/05/2","020         ",-262809.54
15/05/20,1203.00,"","Payment Ex: 70015100647 ","Repayment   ",-261606.54
