Date,Amount,Reference,Description,Particulars,Balance
15/09/19,-1035.95,"","Loan Interest To 14/09/2","019         ",-297092.70
15/09/19,1525.73,"","Payment Ex: 70015100647 ","Repayment   ",-295566.97
15/10/19,-1000.87,"","Loan Interest To 14/10/2","019         ",-296567.84
15/10/19,1525.73,"","Payment Ex: 70015100647 ","Repayment   ",-295042.11
15/11/19,-1032.40,"","Loan Interest To 14/11/2","019         ",-296074.51
15/11/19,1525.73,"","Payment Ex: 70015100647 ","Repayment   ",-294548.78
